{
  "id": "isle-137",
  "seed": 1678886400000,
  "wind": {
    "amp": 3.45,
    "scale": 0.25,
    "gusts": [2, 5, 1]
  },
  "tiles": [
    [".",".",".",".",".",".",".",".",".",".",".",".",".",".",".",".",".",".",".",".",".",".",".",".",".",".",".",".",".",".",".","."],
    [".",".",".",".",".",".",".",".",".",".",".",".",".",".",".",".",".",".",".",".",".",".",".",".",".",".",".",".",".",".",".","."],
    [".",".",".",".",".",".",".",".",".",".",".","X",".",".",".",".",".",".",".",".",".",".",".",".",".",".",".",".",".",".",".","."],
    [".",".",".",".",".",".",".",".",".",".",".","X",".",".",".",".",".",".",".",".",".",".",".",".",".",".",".",".",".",".",".","."],
    [".",".",".",".",".",".",".",".",".",".",".","X",".",".",".",".",".",".",".",".",".",".",".",".",".",".",".",".",".",".",".","."],
    [".",".",".",".",".",".",".",".",".",".",".","X",".",".",".",".",".",".",".",".",".",".",".",".",".",".",".",".",".",".",".","."],
    [".",".",".",".",".",".",".",".",".",".",".",".",".",".",".",".",".",".",".",".",".",".",".",".",".",".",".",".",".",".",".","."],
    [".",".",".",".",".",".",".",".",".",".",".","X",".",".",".",".",".",".",".",".",".",".",".",".",".",".",".",".",".",".",".","."],
    [".",".",".",".",".",".",".",".",".",".",".",".",".",".",".","#","#","#","#","#","#",".",".",".",".",".",".",".",".",".",".","."],
    [".",".",".",".",".",".",".",".",".",".",".",".",".",".",".","#","#","#","#","#","#",".",".",".",".",".",".",".",".",".",".","."],
    [".",".",".",".",".",".",".",".",".",".",".",".",".",".",".","#","#","#","#","#","#",".",".",".",".",".",".",".",".",".",".","."],
    [".",".",".",".",".",".",".",".",".",".",".",".",".",".",".","#","#","#","#","#","#",".",".",".",".",".",".",".",".",".",".","."],
    [".",".",".",".",".",".",".",".",".",".",".",".",".",".",".","#","#","#","#","#","#",".",".",".",".",".",".",".",".",".",".","."],
    [".",".",".",".",".",".",".",".",".",".",".",".",".",".",".","#","#","#","#","#","#",".",".",".",".",".",".",".",".",".",".","."],
    [".",".",".",".","X","X","X","X","X","X","X",".",".",".",".",".",".",".",".",".",".",".",".",".",".",".",".",".",".",".",".","."],
    [".",".",".",".",".",".",".",".",".",".",".",".",".",".",".",".",".",".",".",".",".",".",".",".",".",".",".",".",".",".",".","."],
    [".",".",".",".",".",".",".",".",".",".",".",".",".",".",".",".",".",".",".",".",".",".",".",".",".",".",".",".",".",".",".","."],
    [".",".",".",".",".",".",".",".",".",".",".",".",".",".",".",".",".",".",".",".",".",".",".",".",".",".",".",".",".",".",".","."],
    [".",".",".",".",".",".",".",".",".",".",".",".",".",".",".",".",".",".",".",".",".",".",".",".",".",".",".",".",".",".",".","."],
    [".",".",".",".",".",".",".",".",".",".",".",".",".",".",".",".",".",".",".",".",".",".",".",".",".",".",".",".",".",".",".","."]
  ],
  "patrols": [{
    "path": [[3, 3], [12, 3], [12, 10], [3, 10]],
    "speed": 1.75,
    "type": "drone"
  }],
  "gameObjects": [
    {
      "id": "resource-1",
      "type": "shard",
      "pos": [25, 5]
    },
    {
      "id": "resource-2",
      "type": "fuel",
      "pos": [4, 17]
    },
    {
      "id": "portal-1",
      "type": "exit",
      "pos": [11, 6],
      "target": "isle-138"
    },
    {
      "id": "pickup-1",
      "type": "credit",
      "pos": [16, 11],
      "value": 100
    },
    {
      "id": "hazard-1",
      "type": "mine",
      "pos": [18, 4],
      "damage": 20
    }
  ]
}
